1
16 16
GGGGGGGGGGGGGGGG
GPTTPPPGGPPPPPGG
GPGGGGTGGPGGGPGG
GPPPGGTGGPGGGPGG
GPGGGGPPPPPPPPPG
GPGGGGGPGGGPGGPG
GPGGGGGPGGGPGGPG
GPPPPPPPPPPPGGPG
GTGGPGGGGGPGGGPG
GTGGPGGGGGPPPPPG
GTGGPGGGGGGGPGGG
GPPPPGGGGGGGPGGG
GGGGPPPPPPPPPPPG
GGGGPGGGGGGGGGPG
GPPPPPPPPPPPPPPG
GGGGGGGGGGGGGGGG
8
7 4
m
7 5
f
4 10
f
9 12
f
9 11
m
4 3
f
10 5
f
10 10
m
10
5
3
5
6
5
6
5
60
10