5
26 26
GGGGGGGGGGGGGGGGGGGGGGGGGG
GPPTTTTTPPPPPPPPPTTTTTTTPG
GTGGTGGGPGGGGGGGGGTGGGGGPG
GTTTPGGGPTTTTTTTTTTTPGGGPG
GTGGPGGGPGGTGGGGGGGGPGGGPG
GTGGPPPPPGGTGGPPPPGGPTTTPG
GTGGGGGGPPPPPPPGGPGGPGTGPG
GTGGGGGGPGGGGGPGGPGGPGTGPG
GTGGGGGGPGGGGGPGGGGGPGTGPG
GPPPPPPPPGGGGGPPPPPPPPPPPG
GGGGTGGGTGGGGGTGGGGGTGGGTG
GGGGTGGGTGGGGGTTTTTTTGGGTG
GTTTTTTTTTTGGGGGGGGGTTTTTG
GTGGGGTGGGTGGGGGGGGGTGGGTG
GTGGGGTGGGTTTTTTTTTTTGGGTG
GTGGGGTGGGGGGGTGGGGGGGGGTG
GPPPPPPPPPPPPPPPPPPPPPPPPG
GPGGTGGGGGGPGGTGGGGGTGGGPG
GPGGTGGGGGGPGGTGGGGGTGGGPG
GPTTTTPPPPPPGGTGGGPPPPPPPG
GPGGGGPGGTGPGGTGGGPGGTGGPG
GPGGGGPTTTGPTTTTTTPGGTGGPG
GPTTTTPGGTGGGGGGGGPGGTGGPG
GPGGGGPGGTGGGGGGGGPGGTGGPG
GPPPPPPPPPPPPPPPPPPPPPPPPG
GGGGGGGGGGGGGGGGGGGGGGGGGG
12
8 10
f
1 1
f
8 1
m
24 1
m
16 16
m
24 24
f
1 19
f
4 3
m
24 11
f
10 14
m
15 21
f
16 6
f
10
5
3
5
6
5
6
5
60
15
