4
26 26
GGGGGGGGGGGGGGGGGGGGGGGGGG
GPPPPPPPPPPPPPPPPPPPPPPPPG
GTGGGGGGPGGGGGGGGGGGGGGGPG
GTGGPGGGPTTTTTTTTTTTPGGGPG
GTGGPGGGPGGGGGGGGGGGPGGGPG
GTGGPPPPPGGGGGPPPPGGPGGGPG
GTGGGGGGPPPPPPPGGPGGPGGGPG
GTGGGGGGPGGGGGPGGPGGPGGGPG
GTGGGGGGPGGGGGPGGGGGPGGGPG
GPPPPPPPPGGGGGPPPPPPPPPPPG
GGGGTGGGTGGGGGTGGGGGTGGGTG
GGGGTGGGTGGGGGTTTTTTTGGGTG
GTTTTTTTTTTGGGGGGGGGTTTTTG
GTGGGGTGGGTGGGGGGGGGTGGGTG
GTGGGGTGGGTTTTTTTTTTTGGGTG
GTGGGGTGGGGGGGTGGGGGGGGGTG
GPPPPPPPPPPPPPPPPPPPPPPPPG
GPGGGGGGGGGPGGGGGGGGGGGGPG
GPGGGGGGGGGPGGGGGGGGGGGGPG
GPTTTTPPPPPPGGGGGGPPPPPPPG
GPGGGGPGGGGPGGGGGGPGGGGGPG
GPGGGGPGGGGPTTTTTTPGGGGGPG
GPGGGGPGGGGGGGGGGGPGGGGGPG
GPGGGGPGGGGGGGGGGGPGGGGGPG
GPPPPPPPPPPPPPPPPPPPPPPPPG
GGGGGGGGGGGGGGGGGGGGGGGGGG
12
8 10
f
1 1
f
8 1
m
24 1
m
16 16
m
24 24
f
1 19
f
4 3
m
24 11
f
10 14
m
15 21
f
16 6
f
10
5
3
5
6
5
6
5
60
15
