2
27 27
GGGGGGGGGGGGGGGGGGGGGGGGGGG
GPPPPPPPPGGGGGGGGPPPPPPPPPG
GPGGGGGGPPPPPPGGGPGGGPGGGPG
GPPPPPGGPGGGGPGGGPGGGPGGGPG
GPGGGGGGPGGGGPGGGPGGPPPPPPG
GPGGGGGPPPPPPPPPPPPGPGGGPGG
GPPPPPPPGGGTGGTGGGPGPGGGPGG
GGGGPGGPGTTTGGTTTGPGPGGGPGG
GGGGPGGPGTGGGGGGTGPGPGGGPGG
GGGGPGGPGTGGGGGGTGPGPPPPPGG
GGGGPGGPGTGGGGGGTGPGGGPGGGG
GPPPPGGPGTGGGGGGTGPGGGPGGGG
GGGGPGGPGTGGGGGGTGPGGGPGGGG
GGGGPGGPGTTTTTTTTGPGGGPPPPG
GGGGPGGPGGGGGGGGGGPGGGPGGGG
GGPPPGGPPPPPPPPPPPPPPGPGGGG
GGPGGGGPGPGGGGGGPGGGPGPGGGG
GGPPPPPPGPGGGGGGPGGGPGPGGGG
GGPGGPGGGPPPPPPPPPPGPGPGGGG
GGPGGPGGGGGGPGGGGGPGPGPGGGG
GGPGGPGGGGGGPGGGGGPPPPPPPPG
GGPGGPGGGGGGPGGGGGGPGGGGGPG
GGPGGPGGGGGGPGGGPPPPGGGGGPG
GGPGGPPPPGGGPGGGPGGGGGGGGPG
GGPGGGGGPGGGPGGGPGGGGGGGGPG
GGPPPPPPPPPPPPPPPPPPPPPPPPG
GGGGGGGGGGGGGGGGGGGGGGGGGGG
15
1 1
m
8 5
m
24 1
f
7 15
f
18 25
f
24 25
m
1 25
m
13 25
f
1 11
f
1 6
f
12 18
m
4 6
m
21 1
m
16 22
f
5 23
m
5
5
5
5
5
5
5
5
60
20