3
27 27
GGGGGGGGGGGGGGGGGGGGGGGGGGG
GPPPGGGPPPGGGGGPPPGGGGGGGGG
GGPGGGGGPGGGGGGGPGGGGGPGGPG
GPPPPPPPPPPPPPPPPPPPPPPPPPG
GGPGGGTGPGGPGGGGPGGGGGPGGPG
GPPPGGTGGGPPPGGGPGPGPGGGGGG
GGPGGGTGGGGPGGGGPPPPPTTGGGG
GPPPGGTGGGPPPGGGGGPGPGTGGGG
GGPGGGTGGGGPGGGGGGGGGGTGGGG
GPPPGGTGGGPPPGGGGGGGGGTGGGG
GGPGGGTGGGGPGGPGPGGGGGTGGGG
GGPPPPPPPPPPPPPPPPPPPPPPPPG
GGGGPGGGGGPGGGPGPGGPGGGGGTG
GGGPPPGGGPPPGGGGGGPPPGGGGTG
GGGGPGGGGGPGGGGGGGGPGGGGGTG
GGGPPPGGGPPPGGGGGGPPPGGGGTG
GGGGPGGGGGPGGGGGGGGPGGGGGTG
GGPGPGPGPGPGGGGPGPGPGGGGGTG
GGPPPPPPPPPTTTTPPPPPPPPPPPG
GGPGPGPGPGGGGPGPGPGPGPGGGGG
GGGGPGGGGGGGGPGGGGGGGPGGGGG
GGPGPGPGPGGGPPPGGGGGPPPGGGG
GGPPPPPPPPTGGPGGGGGGGPGGGGG
GGPGGGPGPGTGPPPGGPPPPPGGGGG
GGGGGGGGGGTGGPGGGPGGGPGGGGG
GGGGGGGGGGTTTPPPPPGGPPPGGGG
GGGGGGGGGGGGGGGGGGGGGGGGGGG
8
25 3
f
1 1
m
8 11
m
20 18
f
8 22
m
2 18
f
13 23
m
9 22
f
10
5
3
5
6
5
6
5
60
12